#                                                             #                            
#                                                             #                      
#           #           #                                     #                             
#           #           #                                     #                      
#           #           #                                   #####                          
#    ...    #           #                 ####               ###                    
#           #           #                 #####               #                   
#           #           #      ...        ######                                   
#.................................................................
