#                                                         X           XXXXXXXXXXXXX               
#                                                         #           # ##                                               ##
#           #                                             #                                                              ##
#           #                         ###               #####                                                            ####
#    ...    #                         X###               ###          ##                         ##                      ####
#           #           X             X####               #           X                                  ##            ######
#           #           #      ...    X#####              X           XXXXXX##XXXX       ##                            ######
#........................................................................................XXXXXXXXXXXXXXXXXXXXXXX.............
