#                #XXXXXXXXXX                              X           XXXXXXXXXXXXX               
#                #                                        #           # ##                                               ##
#           #    #                                        #                                                              ##
#           ##   #                    ###               #####                                                            ####
#    ...    #    #                    XX##          ##   ###          ##                         ##                      ####
#           #   ##      X             XXX##               #           X                                  ##            ######
#           #           #      ...    XXX###   ##         X     XX    XXXXXX##XXXX       ##                            ######
#.....................................XXXXXXXXXXXXXXXXXXXXX..............................XXXXXXXXXXXXXXXXXXXXXXX.............
