#                                                             #                            
#                                                             #                      
#           #                                                 #                             
#           #                                                 #                      
#           #                                               #####                          
#    ...    #                             X###               ###                    
#           #           X                 X####               #                   
#           #           #      ...        X#####                                   
#.................................................................

